11111111111111
1P000000000001
10000000000001
10000000000001
10000000C00001
100000000000E1
11111111111111