11111110111111
1P000000000001
00000000000001
1000C0C0C00000
10000000000001
1C0000000000E1
11111111110111