11111111111111
1P000000000001
10000000000001
1000C0C0C0000
10000000000001
1C0000000000E1
11111111111111