111111111111111111111111
100000001111100000000C01
100111000000001011110001
100100011011011001000001
100000010001010011010001
101111010101011110010001
1C10000001C1000000010001
111011101111011111010001
1000100010100000E1001001
10P010111010111111001001
10001000001C000000000001
111111111111111111111111