1111
1P01
1011
1001
1CE1
1111
