11111111111111
1P0000000000Z1
10000010000001
10001111100001
10000010000001
1C0000000000E1
11111111111111
